0
SFFHFFHFFF
FFFFFFFFFF
FFHFFFHFFF
FHFFFFHFFF
FHFFHFFFHF
FFFFFHFFFF
FHFFFFFFFF
FFFFFFFFFF
FFFHFHFFFF
FFHFFFFFFG
